.............
.............
.............
.............
.............
.............
.............

.............
#...#####...#
...#.###.#...
..###ccc###..
...#.###.#...
#...#####...#
.............

O.#.#...#.Pcc
##.##...#####
.......#.....
.............
.....#.......
#####...##.##
ccP.#...#.#.O

.............
.#######.....
...P#####....
....#c.c#....
....#####P...
.....#######.
.............

