.............
.............
.............
.............
.............
.............
.............


.............
#...#####...#
...#.###.#...
..###ccc###..
...#.###.#...
#...#####...#
.............
