##...........
#............
.............
.............
.............
............#
...........##

