.............
..###...#....
........#....
....#.L.#....
....#........
....#...###..
.............

