#...........#
.....f.f.....
.............
.............
.............
.............
#...........#

