.............
..m#######m..
..#...M...#..
..#.......#..
.............
.............
.............
