.............
....f.F.f....
.............
.............
...8.....8...
.............
.............

