....#...#....
..P.......Z..
#...## ##...#
.... ........
#...## ##...#
..P.......Z..
....# ..#....

