.............
.............
.............
....|.H.|....
.............
.............
.............

|............
.............
....|"""|....
.....""".....
...|.""".|...
.............
............|

"""""".""""""
""!"""..!..""
"".""".""".""
..."".!.""...
"".""".""".""
"...!.."""!."
"""""".""""""

............!
.!...........
.............
.....!.!.....
.............
...........!.
!............

