##.........##
#...........#
..###..."""..
..#3#..."&"..
..###..."""..
#...........#
##.........##

