.............
..y#......"y.
..##......"".
.............
..""......##.
..y"......#y.
.............

