.............
.............
......#......
....#"""#....
......#......
.............
.............

