.............
....##..#....
...#""##"#...
..#"""""""#..
...####""#...
.......##....
.............

