.............
.............
.....s.S.....
.............
.....S.s.....
..k.......k..
.............
