h.".......".h
"".........""
.............
.............
.............
"".........""
h.".......".h

