.............
.m#.......#m.
.##.......##.
.............
.##.......##.
.m#.......#m.
.............

