.............
.............
...m..#...#..
......#...#..
......#...#..
...m..#...#..
.............

