............!
.!...........
.............
.....|.|.....
.............
...........!.
!............

