#####...#####
#############
.###########.
.###########.
.###########.
#############
#####...#####

