4....#.#....3
..#.......#..
.#.........#.
.............
.#.........#.
..#.......#..
3....#.#....4
