............!
."!.."."...".
.".".".".".".
...".!.!."...
.".".".".".".
."..."."..!".
!............

