.#...........
#T...."......
....."#".....
....".T."....
....."#".....
......"....T#
...........#.

