.............
..o...U...O..
.............
......u......
.............
..^...8...~..
.............

