#####...#####
#############
.###########.
.####hhh####.
.###########.
#############
#####...#####

