.............
....##p##....
..##.....##..
.p..g.g.g..p.
..##.....##..
....##p##....
.............

