.............
.m#.......#m.
.##.."""..##.
...."..."....
.##.."""..##.
.m#.......#m.
.............

