.............
.M#.......#m.
.##.......##.
.............
.##.......##.
.m#.......#M.
.............

