.............
.............
...########..
...""""""""..
.............
.............
.............

