.............
..o.......u..
.............
..^.......~..
.............
..o.......U..
.............

