.............
....f.F.f....
.............
.............
...O.O.o.O...
.............
.............

