.."......."..
"".........""
.............
.............
.............
"".........""
.."......."..

