.............
.###..|..#.#.
.#...#."...#.
...".#...#.#.
.#.".........
.....#""..##.
.............
