.............
.G.........!.
.............
......|......
.............
.g.........q.
.............

