.....#.#....&
..#.......#..
.#.........#.
.............
.#.........#.
..#.......#..
&....#.#.....
