f...........f
.............
.............
....#...#....
.............
.............
f...........f

