f...........f
.............
.............
....#.I.#....
.............
.............
f...........f

